11111111111111111111111111111
10000000000000000000000000001
1C000000011111011111000000001
10111111010000000001011111101
10P00000011110001111000000001
10111111000000000000011111101
1E00C000011100000111000000001
10111111000000000000011111101
10000000011110001111000000001
10111111010000000001011111101
1C00000001111101111100000C001
10000000000000000000000000001
11111111111111111111111111111