1111111111111111111111111111111111111
100000000000000000000000C000000000011
1000000001111111111111111111111111111
1001000000000000000000000001000000111
1001001111111111111111111111000000111
1001001000000000000000000001000000111
1001011000000000000000000001000000111
1000000000000000000000000001000000111
1011111101111111111111111111111111111
1000000000000000000000000000000000111
1001011010000000000000000000000000111
10010000010000000000000000P0000000111
1001000010000000000000000000000000111
1001011000000000000000000001000000111
1000000000000E0000000000C000000000011
1001111111111111111111111111111111111
1000000000000000000000000001000000111
1011111111111111111111111111111111111
1111111111111111111111111111111111111
