11111111111111111
1P00000000CE00011
11111111111111111