111111111111111111111111111111
100000000000000000000000000001
1C00000001111P1111110000000001
101111110100000000010111111001
100000000111110111110000000001
101111110000000000000111111001
1E00C0000111110111110000000001
101111110000000000000111111001
100000000111110111110000000001
101111110100000000010111111001
1C0000000111110111110000000001
100000000000000000000000000001
111111111111111111111111111111