1111111111111111111111111111
1P000000000C0000000000000SE1
1011111011111011111011111011
1010000010001010000010000011
1010111010101S11101010111011
1010100010101000001010001011
1010111011101111101110111011
1010000001C0000S000000C00001
1111111111111111111111111111