111111111111111111111111111111
1C00000111111101111000000000C1
1011111100000000000101111110C1
10P0000111111111110000000000C1
1011111000000000000001111110C1
1E00000011111101111000000000C1
1011111111000000000001111110C1
1000000000111111111100000000C1
1011111100000000000101111110C1
1C00000111111101111000000000C1
111111111111111111111111111111
